***********************
* *********************
* *                ****
* * ************** ****
* * ***      ***** ****
* * *** **** ***** ****
*                     *
********** ************
*        *            *
* *****  ************ *
* *****               *
* *********************
*                     *
**********E************