***********************
*       *           * *
* *** *** ***** *** * *
*   *         * * * * *
*** ******* *** * * * *
*   *   *   *   * * * *
*** * * ***** *** * * *
* * * *       *     * *
* *** ********* ***** *
* *   *     * *     * *
* * *** * * * ***** * *
* *   * * *   *   * * *
* *** * * ***** * * * *
*     * *       *     *
*******E***************