*****************************************************************************************************
*           *     * *           *     *       *   *             *       *     *         *           *
* *** ***** *** * * * *** ***** *** *** *** *** * * ******* * *** *** * ***** * *** ***** ********* *
* * * *   *   * *   *   *   *     *   * * *     *     *     * *   *   *     *   * *   *       *     *
* * * * ***** * *** *** *** ***** *** * * ***** ******* ******* *** ******* * *** *** * ******* *** *
*   * * *     * * * * * * *   *       *   *   *   *   *         *   *     * *       * * * *   * * * *
*** * * * ***** * * * * * *** ********* *** * ***** * * ********* * ***** * * ***** * * * * * * * * *
* * * *     *   * *   * *   *           *   * *     * *     * *   * *   *   * *   * * * * * *   * * *
* * * ***** *** * *** * *** ************* *** * ***** ***** * * * *** * * *** * * * * * * * ***** * *
*   *   *   *   *     *         *     * * *   * * *       *   * * *   * * *   * * * *     *   *   * *
******* * *** *** ************* *** * * * * *** * * ***** * *** * * *** * * *** * ******* *** *** * *
*     * *     *   *           * *   *   * *     *   *   * * *   * *   * * * *   *       *   *   *   *
* *** * ******* ********* *** * * ******* *********** * * * * ***** *** * *** ********* *** *** *****
*   *   *   *   *         * * * * *   *   *         * * * * *       *   *   *   *     * *   * * *   *
* * ***** *** *** ********* * * * * * * * * ******* * * * ***** ***** ***** *** * ***** *** * * * * *
* *     *       *   *         *   * *   * * *   * *   * * *   *     * *     *   *         *   *   * *
* ***** ******* *** * *********** * ******* * * * ***** * * * ***** * *** *** *********** ********* *
* *   * *     *     *   *       * *           *       * *   * *     *   *   *           *   *       *
*** * * * *** ********* ******* * *********** ********* ***** * ******* *** *** ******* *** * *******
*   *   * * *   *     *         * *   *   *   *         *   * *   *   *   *   *       *   *   *     *
* ***** * * *** *** * ********* * * * * * ***** ********* * * * *** * *** *** *** ***** * ***** *** *
* *     * *   *   * *         * * * *   *       *     *   *   * *   *     * * *   *   * * *   * *   *
* ******* * * *** *********** * * * ************* * *** ********* ********* * ***** * *** * * * * ***
*   *   *   * *   *     *     * * *     *       * * *   *     *   * *       *   *   *   *   *   *   *
*** * * ***** * *** *** * ***** * ***** * * *** * * * ***** * * *** * * ******* * ***** * ********* *
* *   *   *   *   * *   * *     *   * * * * *     * * *     * * *     *       *   *     *   *   *   *
* *** * *** ***** * * *** * ******* * * *** ******* * * ***** * * *********** ***** ******* * *** * *
*   * *         * * * * *         * * *   *     *   * * *   *   *       *   *     * *     *   *   * *
*** ***** ***** * * * * * ******* * * *** * *** * *** * * * *********** *** * ***** * *** *** * *** *
* *     * *   * *   * * *   *   * *     * *   * *   *   * *     *   *   *   *       * *   *   * * * *
* ***** *** * *** *** * * *** * ******* * ***** *********** *** *** * *** * ********* * *** *** * * *
*     * *   *   * *   *   *   *     *   *     *   *       * *       *   * * *   *     *   * *   * * *
***** * * ***** * * ***** * ***** *** ******* *** * *** * * *********** * * * * * *** *** *** *** * *
*     * * *     * *     * * *   *     *     *   *   *   * * *     *   *   * * * * *   *       *     *
* *** * * * ***** ***** *** * * *** *** *** *** * *** *** * * *** * * ***** * * *** ********* ***** *
*   * * * *   * * *   *     * *   * *   * * *   * * * *     *   *   *     *   *   *       * * *   * E
*** * * * *** * * *** ***** * *** * * * * * * *** * * ********* ***** *** ******* * ***** * * * * ***
*   * *   * * *       *   * * *   * * * *   * * *   * *   *   * * *   *   *     * *     * *   * *   *
* * ******* * ******* * * *** * *** *** ***** * *** * * * * * * * * ***** *** *** ***** * *** * *** *
* * *       * *   *   * *     * * *     *     *     *   *   *   * *     *   * *   *     *   * * * * *
* *** * * *** * * ***** ******* * ***** * ***** ***************** ***** *** * * ******* *** *** * * *
* *   * * *   * *   *   *     * *     * * *   * *           *       *   *     *   *   *   * *   * * *
* * *** * * *** *** * *** *** * * ***** * * *** * ***** *** ***** *** *********** * * ***** * *** * *
*   *   * * *   *   *   * *   * *       * *     *     * * *     *   *     *       * *     *   *   * *
* *** ***** * *** ***** *** * * ********* * ******* *** * ***** *** ***** * ******* ***** * ***** * *
* * *   *   *   *   *   *   * * *         * *   *   *   *     *   *     * * *         *   *       * *
* * *** * ***** *** * *** ***** * ********* * * ***** *** *** *** ***** * * ***** *** * *********** *
*     *   *     * *   *   *     * *       *   *     * * * *   *   *     * * *   * *   *         *   *
***** ******* *** ***** *** ***** * ***** ********* * * * * *** *** *** * * * * *** *********** * * *
*             *                   *     *             *   *         *   *     *     *             * *
*****************************************************************************************************