*************************************************************
*     *   *     *     *             *           *       *   *
* *** * * * * * * *** * ***** ***** ***** ***** *** *** * * *
*   *   *   * * * * *   *   *   *         *   * *   * *   * E
*** ********* * * * ***** * * * *********** * * * *** * *****
*   *     *   * *       * * * *     *   * * *   * *   * *   *
* ***** * * *********** * * * ***** * * * * ***** * *** * * *
*       * * *         * * * * *   *   * * * * *   * *   * * *
******* *** * ******* * * * * *** ***** * * * * * * * *** * *
* *   * *   * *     *   * * *     * *   *   *   * *   *   * *
* * * * * *** ***** ***** * ***** * * ***** ***** * *** *** *
*   * * *   * *   *     * * *   * * *     *   *   *   *   * *
* *** * *** * * * * ***** * * *** * ***** *** * ********* * *
*   *   *   *   * *   *   * *   *     *   * * * *   *     * *
******* * * ***** *** * *** *** * ***** *** * * * * * ***** *
*     * * *   *   *   * *     *   *     *   * *   *   *     *
***** *** *** * *** * * ***** * *** ******* * ********* *** *
*   *   * *   *     * * *   * *   *       * *         * * * *
* * *** * *** ******* * * * * *********** * ********* * * * *
* * *   *   * *     * *   * *       *     *         *   * * *
*** * *** * *** * *** ***** ******* * ***** ***** ******* * *
*   * *   *     *     *     *   *   * *       * *   *     * *
* *** * *************** ******* * *** ******* * *** * * * * *
* *   *     *           *       * *       * * *   * * * * * *
* * ******* * *********** ******* ******* * * * *** * * *** *
* *   *     *     *   *         *       * *   *   *   *     *
* *** ***** ***** *** * ******* ******* * * ***** ***********
*   * *   *     *   * * *   * *   *   *   * *     *     *   *
* *** * * ********* * * * * * *** * * ***** * *** * *** *** *
*       *           *     *     *   *         *     *       *
*************************************************************